  
SO  ./textures/bg.xpm
NO  ./textures/wall.xpm

WE ./textures/bg.xpm
EA ./textures/bg.xpm

F ./textures/bg.xpm
C 250, 0, 3


     111111111111111111111
     101000001000000000001
1111101010111111100011111
100010100010000010001
111110101111101011101
100000101000101000001
101111101011101111111
101000001010100000101111111111
101011111010111110101  1000001
101010001010100010101111111111
101110101011101010101
100010101010001010001
111111101011111011101
10000010100010N010001
101110101110101110111
101000100000100010101
101011111111111010101
100010000000000010001
101010111011111111101
101000011100000000001
11111111  11111111111
1
		1
11111111