NO textures/wolfenstein/grey_stone.xpm
SO textures/wolfenstein/purple_stone.xpm
WE textures/wolfenstein/red_brick.xpm
EA textures/wolfenstein/wood.xpm


F 220,100,0
C 226,30, 3  

	    1111111111  1111111111111
        1000000001111000000000001
        1011000001110000000000001
    	1001000000000000000000001
111111111011000001110000000000001
100000000011000001110111111111111
11110111111111011100000010001
11110111111111011101010010001  
11000000110101011100000010001
10000000000000001100000010001
10000000000000001101010010001   1
11000001111101011111011110N00111111
11110111  110101 101111010001   1
11111111  111111 111111111111	




